1111111
10....1
1.11111
1.....1
11.11.1
1..12.1
1111111
