10
10
1111111111
10.......1
1........1
1........1
1........1
1........1
1........1
1..2.....1
1........1
1111111111
