11111111111111111111
1......1.....1.....1
1......1.2...1.....1
1......1.....1.....1
1......1.....1.....1
1......1...........1
1.....01.....1.....1
1......1.....1.....1
1......1.....1.....1
1111.111111111111.11
1......1.....1.....1
1......1...........1
1............1.....1
1......1.....1.....1
11111111111111111111
