11111111111111111111
1.0....1.....1.....1
1.1....1.2...1.....1
1.1....1.....1.....1
1.1....1.....1111111
1.1....1...........1
1.1....1111111.....1
1.1....1.....1.....1
1.1....1.....1.....1
1111.111111111111.11
1.1....1.11111....11
1.1....11.........11
1.1111.......11...11
1.....11111111.111.1
11111111111111111111
