1111111
10....1
1.....1
1...2.1
1111111
