1111111111
10.......1
1.1111.111
1....1...1
1.11.111.1
1..1.....1
1.111111.1
1.12.111.1
1.11.....1
1111111111
